vegetal	final_wcvp_accepted_name
Mesosphaerum suaveolens	Mesosphaerum suaveolens
Pombalia prunifolia	Pombalia prunifolia
Ludwigia nervosa	Ludwigia nervosa
Ocimum basilicum	Ocimum basilicum
Paepalanthus paulensis	Paepalanthus paulensis
Pfaffia pulverulenta	Hebanthe pulverulenta
Eryngium junceum	Eryngium junceum
Schefflera vinosa	Didymopanax vinosus
Alomia fastigiata	Ageratum fastigiatum
Baccharis semiserrata	Baccharis gnidiifolia
Baccharis trinervis	Baccharis trinervis
Eupatorium itatiayensis	Symphyopappus itatiayensis
Eupatorium maximilianii	Chromolaena maximiliani
Mikania eriostrepta	Mikania eriostrepta
Piptocarpha macropoda	NA
Piptocarpha macropoda	(DC.) Baker
Vernonia polyanthes	Vernonanthura polyanthes
Vernonia ruficoma	Vernonanthura membranacea
Vernonia salzmannii	Lepidaploa salzmannii
Vernonia scorpioides	Cyrtocymura scorpioides
Vernonia westiniana	Vernonanthura westiniana
Tabebuia roseoalba	Tabebuia roseoalba
Pachira aquatica	Pachira aquatica
Protium heptaphyllum	Protium heptaphyllum
Croton paulinianus	Croton urucurana
Clethra scabra	NA
Clethra scabra	Pers.
Acosmium subelegans	Leptolobium elegans
Periandra mediterranea	Periandra mediterranea
Schizolobium denudatum	Tachigali denudata
Buddleja brasiliensis	NA
Byrsonima intermedia	Byrsonima intermedia
Tristachya leiostachya	Tristachya leiostachya
Roupala montana	Roupala montana
Bathysa meridionalis	Bathysa australis
Rudgea viburnoides	Rudgea viburnoides
Cupania vernalis	Cupania vernalis
Serjania lethalis	Serjania lethalis
Pouteria torta	Pouteria torta
Acnistus arborescens	Iochroma arborescens
Parkia pendula	Parkia pendula
Tapirira guianense	Tapirira guianensis
Jacaranda	NA
Alves, Rogério M. D. O., Waldschmidt, Ana M., Paixão, Joana F., Santos, Daiane R. and Carvalho, Carlos A. L.. """"""""Geographic Range and Nest Architecture of Cephalotrigona Capitata Smith, 1854 (Apidae: Meliponini) in the State of Bahia, Northeastern Brazil"""""""" Journal of Apicultural Science, vol.63, no.1, 3919, pp.49-60. https://doi.org/10.2478/jas-2019-0006	317373
Euterpe oleracea	Euterpe oleracea
Platonia insignis	Platonia insignis
Cenostigma tocantinum	Cenostigma tocantinum
Casearia grandiflora	Casearia grandiflora
Phthirusa micrantha	Cladocolea micrantha
Byrsonima ciliata	Byrsonima amoena
Byrsonima chrysophylla	Byrsonima chrysophylla
Byrsonima rotunda	Byrsonima rotunda
Miconia myrianthera	Miconia myriantha
Myrcia fallax	Myrcia splendens
Averrhoa carambola	Averrhoa carambola
Clusia insignis	Clusia insignis
Clusia grandifiora	Clusia grandiflora
Clusia panapanari	Clusia panapanari
Euterpe precatoria	Euterpe precatoria
Syzygium malaccense	Syzygium malaccense
Bixa orellana	Bixa orellana
Coffea arabica	Coffea arabica
Helianthus annuus	Helianthus annuus
Bertholletia excelsa	Bertholletia excelsa
Solanum lycopersicum	Solanum lycopersicum
Gossypium hirsutum	Gossypium hirsutum
Theobroma grandiflorum	Theobroma grandiflorum
Manihot esculenta	Manihot esculenta
Myrciaria dubia	Myrciaria dubia
Capsicum annuum	Capsicum annuum
Capsicum chinense	Capsicum chinense
Solanum melongena	Solanum melongena
Spondias mombin	Spondias mombin
Malpighia punicifolia	Malpighia glabra
Byrsonima crassifolia	Byrsonima crassifolia
Psidium guajava	Psidium guajava
Nephelium lappaceum	Nephelium lappaceum
Daucus carota	Daucus carota
Spondias tuberosa	Spondias tuberosa
Fragaria ananassa	Fragaria × ananassa
Persea americana	Persea americana
Caspicum annuum	Capsicum annuum
Citrus sinensis	Citrus x aurantium
Citrus reticulata	Citrus x aurantium f. deliciosa
Mangifera indica	Mangifera indica
Brassica napus	Brassica napus
Allium cepa	Allium cepa
Vouacapoua americana	Vouacapoua americana
Cucumis sativus	Cucumis sativus
Citrullus lanatus	Citrullus lanatus
Cocos nucifera	Cocos nucifera
Cucumis melo	Cucumis melo
Macadamia integrifolia	Macadamia integrifolia
Sechium edule	Sicyos edulis
Malpighia emarginata	Malpighia emarginata
Malpighia glabra	Malpighia glabra
Prunus persica	Prunus persica
Jatropha curcas	Jatropha curcas
Punica granatum	Punica granatum
Ananas ananassoides	Ananas comosus
Pouteria caimito	Pouteria caimito
Cucurbita maxima	Cucurbita maxima
Cucurbita moschata	Cucurbita moschata
Cucurbita pepo	Cucurbita pepo
Schinus terebinthifolius	Schinus terebinthifolia
Dipteryx alata	Dipteryx alata
Mauritia flexuosa	Mauritia flexuosa
Butia paraguayensis	Butia paraguayensis
Eugenia dysenterisca	Eugenia dysenterica
Anacardium occidentale	Anacardium occidentale
Campomanesia phaea	Campomanesia phaea
Copaifera langsdorffii	Copaifera langsdorffii
Crambe abyssinica	Crambe hispanica
Solanum sessiliflorum	Solanum sessiliflorum
Lippia alba	Lippia alba
Cajanus cajan	Cajanus cajan
Campomanesia pubescens	Campomanesia pubescens
Pisidium guajava	Psidium guajava
Acca sellowiana	Feijoa sellowiana
Paullinia cupana	Paullinia cupana
Myrciaria cauliflora	Plinia cauliflora
Ziziphus joazeiro	Sarcomphalus joazeiro
Citrus limonum	Citrus x limon
Citrus aurantifolia	Citrus × aurantiifolia
Passiflora edulis	Passiflora edulis
Passiflora giberti	Passiflora giberti
Passiflora coccinea	Passiflora coccinea
Cucubita melo	Cucurbita pepo
Vaccinium ashei	Vaccinium corymbosum
Byrsonima coccolobifolia	Byrsonima coccolobifolia
Moringa oleifera	Moringa oleifera
Blepharocalyx salicifolius	Blepharocalyx salicifolius
Attalea phalerata	Attalea phalerata
Euterpe edulis	Euterpe edulis
Bactris glaucescens	Bactris glaucescens
Pyrus pyrifolia	Pyrus pyrifolia
Capsicum frutescens	Capsicum frutescens
Eugenia uniflora	Eugenia uniflora
Stryphnodendron coriaceum	Gwilymia coriacea
Byrsonima correaefolia	Byrsonima correifolia
Delonix regia	Delonix regia
Borreria verticillata	Spermacoce verticillata
Asystasia gangetica	Asystasia gangetica
Spondias mombim	Spondias mombin
Elaeis oleifera	Elaeis oleifera
Bidens segetum	Bidens segetum
Vernonia ferruginea	Vernonanthura ferruginea
Vernonia petiolaris	Vernonanthura petiolaris
Caryocar brasiliense	Caryocar brasiliense
Kielmeyera grandiflora	Kielmeyera grandiflora
Kielmeyera rubriflora	Kielmeyera rubriflora
Terminalia argentea	Terminalia argentea
Alchornea schomburgkii	Alchornea discolor
Croton floribundus	Croton floribundus
Croton lanjouwensis	Croton matourensis
Euphorbia milii	Euphorbia milii
Bauhinia variegata	Bauhinia variegata
Caesalpinia peltophoroides	Cenostigma pluviosum
Crotalaria incana	NA
Crotalaria incana	L.
Peltophorum dubium	Peltophorum dubium
Hyptis cana	Hyptidendron canum
Hyptis crenata	Hyptis crenata
Banisteriopsis pubipetala	Diplopterys pubipetala
Byrsonima crassa	Byrsonima crassa
Mascagnia cordifolia	Mascagnia cordifolia
Miconia fallax	Miconia fallax
Myrcia amazonica	Myrcia amazonica
Zea mays	Zea mays
Genipa americana	Genipa americana
Solanum lycocarpum	Solanum lycocarpum
Solanum paniculatum	Solanum paniculatum
Thunbergia grandiflora	Thunbergia grandiflora
Euphorbia pulcherrima	Euphorbia pulcherrima
Bauhinia rufa	Bauhinia rufa
Ligustrum lucidum	Ligustrum lucidum
Plumbago capensis	Plumbago auriculata
Pentas lanceolata	Pentas lanceolata
Pachystachys lutea	Pachystachys lutea
Sanchezia nobilis	Sanchezia oblonga
Condylocarpon isthmicum	Condylocarpon isthmicum
Oreopanax capitatus	Oreopanax capitatus
Baccharis rufescens	Baccharis rufescens
Gochnatia barrosii	Moquiniastrum barrosoae
Lychnophora rosmarinifolia	Lychnophora rosmarinifolia
Richterago polyphylla	Richterago polyphylla
Vernonia grandiflora	Lessingianthus grandiflorus
Jacaranda mimosifolia	Jacaranda mimosifolia
Jacaranda oxyphylla	Jacaranda caroba
Pachira cf. aquatica	Pachira aquatica
Couepia grandiflora	Couepia grandiflora
Clethra scabra	Clethra scabra
Senna alata	Senna alata
Ocotea dispersa	Ocotea dispersa
Heteropterys byrsonimifolia	Heteropterys byrsonimifolia
Hibiscus rosa-sinensis	Hibiscus rosa-sinensis
Rapanea guianensis	Myrsine guianensis
Myrcia bella	Myrcia bella
Psidium incanescens	Psidium grandifolium
Ouratea spectabilis	Ouratea spectabilis
Coccoloba ovata	Coccoloba ovata
Coccoloba ramosissima	Coccoloba ramosissima
Waltheria communis	Waltheria communis
Duranta repens	Duranta erecta
Cassia grandis	Cassia grandis
Cassia latifolia	Senna latifolia
Cassia quinquangulata	Senna quinquangulata
Hymenaea courbaril	Hymenaea courbaril
Mimosa pudica	Mimosa pudica
Bellucia grossularioides	Bellucia grossularioides
Miconia myriantha	Miconia myriantha
Solanum caavurana	Solanum caavurana
Cosmos caudatus	Cosmos caudatus
Ouratea semiserrata	Ouratea semiserrata
Ilex nummularia	Ilex nummularia
Eremanthus glomerulatus	Eremanthus glomerulatus
Symphyopappus reticulatus	Symphyopappus reticulatus
Vernonia brasiliana	Vernonanthura brasiliana
Vernonia rubriramea	Vernonanthura rubriramea
Zeyheria digitalis	Zeyheria montana
Acosmium dasycarpum	Leptolobium dasycarpum
Chamaecrista cavalcantina	Chamaecrista cavalcantina
Chamaecrista desvauxii	Chamaecrista desvauxii
Diplusodon buxifolius	Diplusodon buxifolius
Diplusodon orbicularis	Diplusodon orbicularis
Cambessedesia corymbosa	Cambessedesia corymbosa
Marcetia taxifolia	Marcetia taxifolia
Trembleya laniflora	Microlicia laniflora
Luxemburgia schwackeana	Luxemburgia schwackeana
Ouratea castaneifolia	Ouratea castaneifolia
Styrax camporum	Styrax camporum
Symplocos nitens	Symplocos nitens
Qualea parviflora	Qualea parviflora
Tapirira guianensis	Tapirira guianensis
Dendropanax cuneatus	Dendropanax cuneatus
Piptocarpha axillaris	Piptocarpha axillaris
Trixis praestans	Trixis praestans
Vernonia puberula	Vernonanthura puberula
Vernonia diffusa	Vernonanthura divaricata
Begonia fruticosa	Begonia fruticosa
Begonia integerrima	Begonia integerrima
Begonia semperflorens	Begonia cucullata
Cordia trichoclada	Cordia trichoclada
Tovomitopsis paniculata	Tovomitopsis paniculata
Inga marginata	Inga marginata
Mimosa invisa	Mimosa invisa
Stryphnodendron guianense	Stryphnodendron guianense
Casearia sylvestris	Casearia sylvestris
Struthanthus concinnus	Struthanthus concinnus
Miconia cabucu	Miconia formosa
Miconia inaegidans	Miconia inaequidens
Miconia theaezans	Miconia theaezans
Campomanesia xanthocarpa	Campomanesia xanthocarpa
Eugenia oblongata	Eugenia disperma
Myrceugenia myrcioides	Myrceugenia myrcioides
Myrcia rostrata	Myrcia splendens
Coccoloba martii	Coccoloba peltata
Bathysa australis	Bathysa australis
Borreria radula	Bourreria tomentosa
Psychotria vellosiana	Palicourea sessilis
Psychotria suterella	Psychotria suterella
Cupania oblongifolia	Cupania oblongifolia
Cupania zanthoxyloides	Cupania zanthoxyloides
Paullinia carpopodea	Paullinia carpopodea
Serjania reticulata	Serjania reticulata
Solanum inaequale	Solanum pseudoquina
Solanum megalochiton	Solanum megalochiton
Solanum variabile	Solanum variabile
Stachytarpheta cayennensis	Stachytarpheta cayennensis
Schinus terebinthifolia	Schinus terebinthifolia
Tapirira guianenesis	Tapirira guianensis
Syagrus coronata	Syagrus coronata
Arrabidaea agnus-castus	Fridericia rego
Jacquemontia serrata	Daustinia montana
Erythroxylum passerinum	Erythroxylum passerinum
Andira fraxinifolia	Andira fraxinifolia
Bowdichia virgilioides	Bowdichia virgilioides
Senna macranthera	Senna macranthera
Senna rizzinii	Senna rizzinii
Krameria tomentosa	Krameria tomentosa
Struthanthus polyrrhizos	Struthanthus retusus
Byrsonima cydoniifolia	Byrsonima cydoniifolia
Byrsonima sericea	Byrsonima sericea
Richardia grandiflora	Richardia grandiflora
Centella biflora	Centella erecta
Schefflera angustissima	Didymopanax angustissimus
Baccharis anomala	Baccharis anomala
Baccharis  grandimucronata	Baccharis grandimucronata
Baccharis tridentata	Baccharis tridentata
Bidens gardneri	Bidens gardneri
Eupatorium vauthierianum	Heterocondylus alatus
Gochnatia polymorpha	Moquiniastrum polymorphum
Gochnatia pulchra	Moquiniastrum pulchrum
Mikania biformis	Mikania biformis
Mikania catharinensis	Mikania lundiana
Mikania hoffmanniana	Mikania hoffmanniana
Mikania cynanchifolia	Mikania cynanchifolia
Mikania laevigata	Mikania laevigata
Mikania trinervis	Mikania trinervis
Mikania ulei	Mikania ulei
Senecio desiderabilis	Pentacalia desiderabilis
Solidago chilensis	Solidago chilensis
Vernonia flexuosa	Chrysolaena flexuosa
Protium widgrenii	Protium widgrenii
Lobelia camporum	Lobelia camporum
Sambucus australis	Sambucus australis
Merremia dissecta	Distimake dissectus
Weinmannia discolor	Weinmannia discolor
Weinmannia pinnata	Weinmannia pinnata
Croton cf. paulinianus	Croton urucurana
Croton macrobothrys	Croton macrobothrys
Manihot grahamii	Manihot grahamii
Sapium glandulatum	Sapium glandulosum
Acacia paniculata	Senegalia paniculata
Acacia polyphylla	Senegalia polyphylla
Bauhinia microstachya	Schnella microstachya
Caesalpinia pluviosa	Cenostigma pluviosum
Glycyrrhiza glabra	Glycyrrhiza glabra
Machaerium nyctitans	Machaerium nyctitans
Piptadenia gonoacantha	Piptadenia gonoacantha
Senna rugosa	Senna rugosa
Casearia decandra	Casearia decandra
Hyptis eriophylla	Medusantha eriophylla
Aiouea trinervis	Aiouea trinervis
Nectandra barbellata	Nectandra barbellata
Ocotea glaziovii	Ocotea glaziovii
Ocotea puberula	Ocotea puberula
Lafoensia nummularifolia	Lafoensia nummulariifolia
Miconia rigidiuscula	Miconia pusilliflora
Mutingia calabura	Muntingia calabura
Calyptranthes grandifolia	Myrcia loranthifolia
Myrcia glabra	Myrcia glabra
Myrcia pubipetala	Myrcia pubipetala
Myrcia tomentosa	Myrcia tomentosa
Heisteria silvianii	Heisteria silvianii
Piper gaudichaudianum	Piper gaudichaudianum
Hovenia dulcis	Hovenia dulcis
Prunus sellowii	Prunus reflexa
Rubus rosifolius	Rubus rosifolius
Borreria suaveolens	Spermacoce suaveolens
Emmeorhiza umbellata	Emmeorhiza umbellata
Zanthoxylum hyemale	Zanthoxylum fagara
Salix humboldtiana	Salix humboldtiana
Allophylus edulis	Allophylus edulis
Allophylus petiolulatus	Allophylus petiolulatus
Matayba elaeagnoides	Matayba elaeagnoides
Paullinia seminuda	Paullinia seminuda
Serjania erecta	Serjania erecta
Serjania multiflora	Serjania multiflora
Urvillea laevis	Urvillea laevis
Nicandra physalodes	Nicandra physalodes
Daphnopsis gemmiflora	Daphnopsis martii
Trema micrantha	Drimia macrantha
Lithraea molleoides	Lithraea molleoides
Erythroxylum tortuosum	Erythroxylum tortuosum
Stryphnodendron polyphyllum	Stryphnodendron polyphyllum
Hyptis multibracteata	Hyptis multibracteata
Myrcia albatomentosa	Myrcia albotomentosa
Myrcia lingua	Myrcia guianensis
Psychotria sessilis	Rudgea sessilis
Luehea speciosa	Luehea speciosa
Dimorphandra mollis	Dimorphandra mollis
Conocliniopsis prasiifolia	Conocliniopsis grossedentata
Cordia verbenacea	Varronia curassavica
Chamaecrista ramosa	Chamaecrista ramosa
Eschweilera ovata	Eschweilera ovata
Bougainvillea spectabilis	Bougainvillea spectabilis
Allamanda cathartica	Allamanda cathartica
Thevetia peruviana	Cascabela thevetia
Archontophoenix cunninghamiana	Archontophoenix cunninghamiana
Butia leiospatha	Butia capitata
Aspilia reflexa	Wedelia reflexa
Baccharis dracunculifolia	Baccharis dracunculifolia
Elephantopus angustifolius	Orthopappus angustifolius
Eremanthus sphaerocephalus	Chresta sphaerocephala
Eupatorium maximiliani	Chromolaena maximiliani
Eupatorium squalidum	Chromolaena squalida
Mikania cordifolia	Mikania cordifolia
Parthenium hysterophorus	Parthenium hysterophorus
Stilpnopappus speciosus	Stilpnopappus speciosus
Trichogonia salviifolia	Trichogonia salviifolia
Wulffia stenoglossa	Tilesia baccata
Pyrostegia venusta	Pyrostegia venusta
Talinum racemosum	NA
Ceiba speciosa	Ceiba speciosa
Eriotheca gracilipes	Eriotheca gracilipes
Scleria bracteata	Scleria bracteata
Erythroxylum nitidum	Erythroxylum deciduum
Croton glandulosus	Croton glandulosus
Anadenanthera falcata	Anadenanthera peregrina
Chamaecrista nictitans	Chamaecrista nictitans
Desmodium pachyrrhizum	Desmodium pachyrhizum
Platypodium elegans	Platypodium elegans
Hyptis rugosa	Cyanocephalus rugosus
Dracaena fragrans	Dracaena fragrans
Diplusodon villosus	Diplusodon villosus
Banisteriopsis laevifolia	Banisteriopsis laevifolia
Melia azedarach	Melia azedarach
Myrcia uberavensis	Myrcia uberavensis
vochysia rufa	Vochysia rufa
Oxalis physocalyx	Oxalis physocalyx
Axonopus barbigerus	Axonopus siccus
Echinolaena inflexa	Echinolaena inflexa
Gymnopogon foliosus	Gymnopogon foliosus
Paspalum notatum	Paspalum notatum
Paspalum plicatulum	Paspalum plicatulum
Rhynchelytrum roseum	Melinis repens
Grevillea banksii	Grevillea banksii
Triumfetta bartramia	NA
Turnera ulmifolia	Turnera ulmifolia
Vochysia rufa	Vochysia rufa
Bauhinia ungulata	Bauhinia ungulata
Axonopus polydactylus	Axonopus polydactylus
Trachypogon plumosus	Trachypogon spicatus
Fimbristylis capilaris	Bulbostylis capillaris
Byrsonima verbascifolia	Byrsonima verbascifolia
Justicia brandegeana	Justicia brandegeeana
Odontonema strictum	Odontonema tubaeforme
Ruellia geminiflora	Ruellia geminiflora
Mesembryanthemum spectabile	Lampranthus spectabilis
Alternanthera ficoidea	Alternanthera ficoidea
Amaranthus spinosus	Amaranthus spinosus
Gomphrena celosioides	Gomphrena celosioides
Rhus vernicifera	NA
Schinus terenbifolia	Lithraea molleoides
Foeniculum vulgare	Foeniculum vulgare
Petroselinum hortense	Petroselinum crispum
Catharanthus roseus	Catharanthus roseus
Didymopanax vinosus	Didymopanax vinosus
Schefflera vinosum	Didymopanax vinosus
Tetrapanax papyrifer	Tetrapanax papyrifer
Asclepias curassavica	Asclepias curassavica
Acanthospermum australe	Acanthospermum australe
Achyrocline satureioides	Achyrocline saturejoides
Ageratum conyzoides	Ageratum conyzoides
Aster laevis	Symphyotrichum laeve
Baccharidastrum triplinervium	Archibaccharis vulneraria
Baccharis reticulata	Baccharis genistelloides
Bidens pilosa	Bidens pilosa
Coreopsis grandiflora	Coreopsis grandiflora
Cosmos sulphureus	Cosmos sulphureus
Eclipta alba	Eclipta prostrata
Elephantopus biflorus	Elephantopus biflorus
Emilia fosbergii	Emilia fosbergii
Emilia sonchifolia	Emilia sonchifolia
Galinsoga parviflora	Galinsoga parviflora
Stifftia chrysantha	Stifftia chrysantha
Tithonia speciosa	Tithonia rotundifolia
Vernonia bardanoides	Lessingianthus bardanoides
Vernonia cognata	Chrysolaena cognata
Vernonia coriacea	Lessingianthus coriaceus
Wedelia paludosa	Sphagneticola trilobata
Impatiens balsamina	Impatiens balsamina
Impatiens sultanii	Impatiens walleriana
Arrabidaea chica	Fridericia chica
Memora peregrina	Adenocalymma peregrinum
Spathodea campanulata	Spathodea campanulata
Tabebuia chrysotricha	Handroanthus chrysotrichus
Tabebuia impetiginosa	Handroanthus impetiginosus
Bombax ceiba	Bombax ceiba
Ceiba erianthos	Ceiba erianthos
Eriotheca candolleana	Eriotheca candolleana
Pseudobombax tomentosum	Pseudobombax tomentosum
Cordia glabrata	Cordia glabrata
Cordia superba	Cordia superba
Cordia trichotoma	Cordia trichotoma
Cleome spinosa	Cleome spinosa
Lonicera japonica	Lonicera japonica
Silene armeria	Atocion armeria
Hirtella glandulosa	Hirtella glandulosa
Licania humilis	Leptobalanus humilis
Licania parviflora	Licania parviflora
Kielmeyera coriacea	Kielmeyera coriacea
Cochlospermum vitifolium	Cochlospermum vitifolium
Combretum laxum	Combretum laxum
Tradescantia purpurea	Tradescantia pallida
Rourea induta	Rourea induta
Evolvulus kramerioides	Evolvulus kramerioides
Davilla elliptica	Davilla elliptica
Muntingia calabura	Muntingia calabura
Rhododendron indicum	Rhododendron indicum
Rhododendron simsii	Rhododendron simsii
Rhododendron x	Rhododendron
Alchornea sidifolia	Alchornea sidifolia
Alchornea triplinervia	Alchornea triplinervia
Chamaesyce hirta	Euphorbia hirta
Euphorbia splendens	Euphorbia splendens
Pera glabrata	Pera glabrata
Sebastiania serrata	Sebastiania serrata
Anadenanthera colubrina	Anadenanthera colubrina
Andira humilis	Andira humilis
Caesalpinia pyramidalis	Cenostigma pyramidale
Calliandra tweediei	Calliandra tweediei
Cassia fistula	Cassia fistula
Cassia leptophylla	Cassia leptophylla
Centrolobium tomentosum	Centrolobium tomentosum
Clitoria fairchildiana	Clitoria fairchildiana
Crotalaria pallida	Crotalaria pallida
Crotalaria incana	Crotalaria incana
Crotalaria juncea	Crotalaria juncea
Crotalaria lanceolata	Crotalaria lanceolata
Erythrina speciosa	Erythrina speciosa
Leucaena leucocephala	Leucaena leucocephala
Macroptilium lathyroides	Macroptilium lathyroides
Mimosa daleoides	Mimosa daleoides
Myroxylon balsamum	Myroxylon balsamum
Piptadenia rigida	Parapiptadenia rigida
Senna multijuga	Senna multijuga
Senna rostrata	Senna rostrata
Stylosanthes scabra	Stylosanthes scabra
Tamarindus indica	Tamarindus indica
Tipuana speciosa	Tipuana tipu
Tipuana tipu	Tipuana tipu
Zornia brasiliensis	Zornia brasiliensis
Belamcanda chinensis	Iris domestica
Dietes vegeta	Moraea vegeta
Hyptis marrubioides	Hyptis marrubioides
Hyptis mutabilis	Cantinoa mutabilis
Hyptis suaveolens	Mesosphaerum suaveolens
Hyptis umbrosa	Mesosphaerum sidifolium
Origanum vulgare	Origanum vulgare
Salvia splendens	Salvia splendens
Tetradenia riparia	Tetradenia riparia
Persea gratissima	Persea americana
Bulbine frutescens	Bulbine frutescens
Cordyline terminalis	NA
Struthanthus uraguensis	Struthanthus uraguensis
Adenaria floribunda	Adenaria floribunda
Lagerstroemia indica	Lagerstroemia indica
Byrsonima basiloba	Byrsonima basiloba
Byrsonima lancifolia	Byrsonima lancifolia
Byrsonima orbignyana	Byrsonima cydoniifolia
Heteropterys campestris	Heteropterys campestris
Malvaviscus arboreus	Malvaviscus arboreus
Sida rhombifolia	Sida rhombifolia
Tibouchina chamissoana	Pleroma molle
Tibouchina granulosa	Pleroma granulosum
Tibouchina holosericea	Pleroma clavatum
Tibouchina radula	Pleroma radula
Artocarpus integrifolia	NA
Morus alba	Morus alba
Morus nigra	Morus nigra
Sorocea bonplandii	Sorocea bonplandii
Callistemon viminalis	Melaleuca viminalis
Eucalyptus blakelyi	Eucalyptus blakelyi
Eucalyptus cinerea	Eucalyptus cinerea
Eucalyptus robusta	Eucalyptus robusta
Eucalyptus rudis	Eucalyptus rudis
Eucalyptus tereticornis	Eucalyptus tereticornis
Eugenia jambos	Syzygium jambos
Eugenia malaccensis	Syzygium malaccense
Eugenia pitanga	Eugenia pitanga
Eugenia punicifolia	Eugenia punicifolia
Myrcia largipes	Myrcia tomentosa
Jasminum azoricum	Jasminum azoricum
Ludwigia laruotteana	Ludwigia laruotteana
Oxalis latifolia	Oxalis latifolia
Antigonon leptopus	Antigonon leptopus
Coccoloba mollis	Coccoloba mollis
Polygonum capitatum	Persicaria capitata
Portulaca elatior	Portulaca elatior
Rhamnidium elaeocarpum	Rhamnidium elaeocarpum
Alibertia sessilis	Cordiera sessilis
Chomelia pohliana	Chomelia pohliana
Coussarea hydrangeifolia	Coussarea hydrangeifolia
Declieuxia dusenii	Declieuxia dusenii
Gardenia jasminoides	Gardenia jasminoides
Psychotria carthagenensis	Psychotria carthagenensis
Citrus limon	Citrus × limon
Zanthoxylum rhoifolium	Zanthoxylum rhoifolium
Matayba guianensis	Matayba guianensis
Serjania caracasana	Serjania caracasana
Serjania communis	Serjania communis
Serjania glabrata	Serjania glabrata
Manilkara achras	Manilkara zapota
Paulownia tomentosa	Paulownia tomentosa
Russelia equisetiformis	Russelia equisetiformis
Nicotiana tabacum	Nicotiana tabacum
Solanum americanum	Solanum americanum
Dombeya burgessiae	Dombeya burgessiae
Dombeya wallichii	Dombeya wallichii
Melochia tomentosa	Melochia tomentosa
Camellia japonica	Camellia japonica
Camellia sinensis	Camellia sinensis
Heliocarpus americanus	Heliocarpus americanus
Luehea divaricata	Luehea divaricata
Lantana camara	Lantana camara
Petrea volubilis	Petrea volubilis
Vitex megapotamica	Vitex megapotamica
Anchietea parvifolia	Anchietea pyrifolia
Salvertia convallariodora	Salvertia convallariodora
Vochysia cinnamomea	Vochysia cinnamomea
Echinodorus grandiflorus	Aquarius grandiflorus
Crinum x	Crinum
Schefflera macrocarpa	Didymopanax macrocarpus
Montanoa bipinnatifida	Montanoa bipinnatifida
Merremia macrocalyx	Distimake macrocalyx
Aleurites fordii	Vernicia fordii
Anadenanthera macrocarpa	Anadenanthera colubrina
Mimosa nuda	Mimosa debilis
Hyptis crinita	Medusantha crinita
Yucca filamentosa	Yucca filamentosa
Microlicia cuneata	NA
Campomanesia aromatica	Campomanesia aromatica
Psidium firmum	Psidium firmum
Grevillea robusta	Grevillea robusta
Magonia pubescens	Magonia pubescens
Symplocos lanceolata	Symplocos oblongifolia
Lippia salviifolia	Lippia origanoides
Qualea grandiflora	Qualea grandiflora
Caryocar cuneatum	Caryocar cuneatum
Chamaecrista diphylla	Chamaecrista diphylla
Copaifera martii	Copaifera martii
Parkia platycephala	Parkia platycephala
Polygala longicaulis	Polygala longicaulis
Turnera melochioides	Turnera melochioides
Amasonia hirta	Amasonia hirta
Plathymenia foliolosa	Plathymenia reticulata
Ludwigia elegans	Ludwigia elegans
Rosa chinensis	Rosa chinensis
Distictella mansoana	Amphilophium mansoanum
Erythroxylum campestre	Erythroxylum campestre
Miconia ligustroides	Miconia ligustroides
Schefflera morototoni	Didymopanax morototoni
Maximiliana martiana	Attalea maripa
Carica papaya	Carica papaya
Artocarpus incisa	Artocarpus altilis
Syzygium jambolanum	Syzygium cumini
